##########
#P     G #
#  ##    #
#  ^  T  #
#    ##  #
#   G    #
#   ^    #
#      E #
#        #
##########